2
0 10 0 40 7 4
10 24 0 50 7 5
24
224 384 352 384 2 1 5 0
352 384 352 320 2 1 5 90
352 320 320 320 2 1 5 0
320 320 320 288 2 1 5 90
320 288 288 288 2 1 5 0
288 288 288 320 2 1 5 90
288 320 256 320 2 1 5 0
256 320 256 288 2 1 5 90
256 288 224 288 2 1 5 0
224 288 224 384 2 1 5 90
224 224 320 224 19 2 6 0
320 224 320 160 19 2 6 90
320 160 384 160 19 2 6 0
384 160 384 96 19 2 6 90
384 96 384 32 19 2 6 90
384 32 320 32 19 2 6 0
320 32 320 96 19 2 6 90
320 96 256 96 19 2 6 0
256 96 192 96 19 2 6 0
192 96 128 96 19 2 6 0
128 96 128 160 19 2 6 90
128 160 192 160 19 2 6 0
192 160 192 224 19 2 6 90
192 224 224 224 19 2 6 0

288 48 30 0 0
